biosample	BioSample
chebi	ChEBI
chembl_compound	ChEMBLCompound
clinvar	ClinVar
dbsnp	DbSNP
ensembl_gene	EnsemblGene
ensembl_transcript	EnsemblTranscript
glytoucan	Glytoucan
go	GO
hgnc	HGNC
homologene	HomoloGene
hp	HPO
medgen	MedGen
mesh	MeSH
mondo	Mondo
nando	Nando
ncbigene	NCBIGene
pdb	PDB
pubchem_compound	PubChemCompound
pubmed	PubMed
rhea	Rhea
togovar	TogoVar
uniprot	UniProt
